"age.min";"age.max";"code_dep";"year";"all";"male";"female"
0;4;"01";2012;39950;20347;19603
0;4;"91";2012;87099;44569;42530
0;4;"85";2012;39607;20231;19376
0;4;"79";2012;21683;11221;10462
0;4;"73";2012;24773;12599;12174
0;4;"14";2012;40881;20954;19927
0;4;"67";2012;64164;32949;31215
0;4;"61";2012;16382;8486;7896
0;4;"55";2012;11174;5679;5495
0;4;"86";2012;24815;12656;12159
0;4;"49";2012;52048;26529;25519
0;4;"43";2012;12784;6482;6302
0;4;"37";2012;33378;17399;15979
0;4;"68";2012;45051;23115;21936
0;4;"31";2012;73503;37720;35783
0;4;"25";2012;34131;17443;16688
0;4;"2A";2012;6803;3511;3292
0;4;"50";2012;27429;13825;13604
0;4;"44";2012;82709;42385;40324
0;4;"08";2012;17689;9281;8408
0;4;"02";2012;34844;17970;16874
0;4;"92";2012;114523;58633;55890
0;4;"26";2012;29920;15235;14685
0;4;"80";2012;34641;17751;16890
0;4;"74";2012;47106;24083;23023
0;4;"15";2012;6952;3392;3560
0;4;"09";2012;7854;4060;3794
0;4;"62";2012;97418;49678;47740
0;4;"56";2012;41621;21417;20204
0;4;"87";2012;19668;9914;9754
0;4;"81";2012;20146;10472;9674
0;4;"75";2012;121837;61157;60680
0;4;"38";2012;79522;41071;38451
0;4;"69";2012;115756;59177;56579
0;4;"32";2012;9102;4680;4422
0;4;"57";2012;60291;30881;29410
0;4;"2B";2012;8207;4238;3969
0;4;"51";2012;34048;17557;16491
0;4;"45";2012;42873;21926;20947
0;4;"39";2012;15253;8005;7248
0;4;"03";2012;16844;8486;8358
0;4;"93";2012;127655;65349;62306
0;4;"27";2012;39415;19832;19583
0;4;"21";2012;29350;14860;14490
0;4;"52";2012;10022;5201;4821
0;4;"16";2012;18262;9505;8757
0;4;"10";2012;18798;9639;9159
0;4;"63";2012;33625;17037;16588
0;4;"94";2012;94554;47446;47108
0;4;"88";2012;21525;10990;10535
0;4;"82";2012;15090;7664;7426
0;4;"76";2012;77389;40003;37386
0;4;"17";2012;31588;16291;15297
0;4;"70";2012;14901;7799;7102
0;4;"33";2012;82952;42493;40459
0;4;"58";2012;10496;5328;5168
0;4;"89";2012;20030;10140;9890
0;4;"83";2012;52879;27217;25662
0;4;"46";2012;8140;4148;3992
0;4;"40";2012;20230;10369;9861
0;4;"04";2012;8284;4288;3996
0;4;"34";2012;59166;30063;29103
0;4;"28";2012;28477;14589;13888
0;4;"22";2012;34019;17510;16509
0;4;"53";2012;20285;10240;10045
0;4;"47";2012;17174;8772;8402
0;4;"11";2012;19190;9830;9360
0;4;"64";2012;33639;17099;16540
0;4;"95";2012;87616;44867;42749
0;4;"29";2012;50939;26152;24787
0;4;"23";2012;5458;2729;2729
0;4;"77";2012;95841;48541;47300
0;4;"18";2012;16318;8263;8055
0;4;"71";2012;29760;15271;14489
0;4;"65";2012;11095;5706;5389
0;4;"59";2012;175986;90731;85255
0;4;"90";2012;8987;4565;4422
0;4;"84";2012;32909;16954;15955
0;4;"78";2012;98521;49948;48573
0;4;"41";2012;19242;9778;9464
0;4;"05";2012;7241;3674;3567
0;4;"35";2012;64788;32764;32024
0;4;"60";2012;54873;28030;26843
0;4;"974";2012;68137;35044;33093
0;4;"54";2012;41739;21219;20520
0;4;"48";2012;4054;2028;2026
0;4;"12";2012;14296;7275;7021
0;4;"06";2012;57314;29094;28220
0;4;"971";2012;26805;13809;12996
0;4;"30";2012;41256;21380;19876
0;4;"24";2012;19507;10051;9456
0;4;"972";2012;23686;12113;11573
0;4;"19";2012;11677;5982;5695
0;4;"72";2012;35515;18146;17369
0;4;"66";2012;24313;12441;11872
0;4;"42";2012;45462;23307;22155
0;4;"36";2012;11494;5844;5650
0;4;"973";2012;28440;14591;13849
0;4;"07";2012;17444;8815;8629
0;4;"13";2012;117121;59445;57676
5;9;"73";2012;25972;13467;12505
5;9;"55";2012;12175;6348;5827
5;9;"75";2012;105214;53846;51368
5;9;"37";2012;35263;18070;17193
5;9;"76";2012;78481;39789;38692
5;9;"39";2012;16566;8507;8059
5;9;"38";2012;79490;40849;38641
5;9;"74";2012;47847;24504;23343
5;9;"2A";2012;7216;3584;3632
5;9;"21";2012;30136;15540;14596
5;9;"23";2012;5835;3037;2798
5;9;"77";2012;96091;49268;46823
5;9;"40";2012;22607;11440;11167
5;9;"42";2012;45817;23453;22364
5;9;"57";2012;60691;31091;29600
5;9;"2B";2012;8334;4368;3966
5;9;"22";2012;36147;18629;17518
5;9;"24";2012;21464;10774;10690
5;9;"78";2012;97993;50422;47571
5;9;"41";2012;19834;10221;9613
5;9;"56";2012;44668;23019;21649
5;9;"58";2012;11549;5788;5761
5;9;"60";2012;55899;28219;27680
5;9;"91";2012;84454;43180;41274
5;9;"85";2012;40283;20793;19490
5;9;"79";2012;22740;11582;11158
5;9;"50";2012;29785;15451;14334
5;9;"14";2012;42560;21804;20756
5;9;"59";2012;173867;89444;84423
5;9;"61";2012;17764;9038;8726
5;9;"92";2012;101142;51132;50010
5;9;"86";2012;25042;12824;12218
5;9;"49";2012;52910;27308;25602
5;9;"43";2012;13987;7171;6816
5;9;"15";2012;7611;3844;3767
5;9;"01";2012;41347;21063;20284
5;9;"31";2012;71831;37085;34746
5;9;"25";2012;32495;16929;15566
5;9;"87";2012;19777;10087;9690
5;9;"81";2012;21696;10904;10792
5;9;"44";2012;84182;43108;41074
5;9;"67";2012;64731;33071;31660
5;9;"02";2012;35924;18308;17616
5;9;"32";2012;10197;5228;4969
5;9;"26";2012;31328;16293;15035
5;9;"80";2012;35988;18285;17703
5;9;"51";2012;34184;17512;16672
5;9;"45";2012;42473;21575;20898
5;9;"68";2012;46618;23705;22913
5;9;"62";2012;99687;51139;48548
5;9;"93";2012;113394;57677;55717
5;9;"27";2012;40893;21024;19869
5;9;"89";2012;21067;10823;10244
5;9;"52";2012;10758;5431;5327
5;9;"16";2012;19153;9790;9363
5;9;"69";2012;106288;53698;52590
5;9;"63";2012;34337;17285;17052
5;9;"94";2012;86032;44397;41635
5;9;"88";2012;22905;11562;11343
5;9;"82";2012;15380;7760;7620
5;9;"53";2012;21091;10860;10231
5;9;"17";2012;33938;17422;16516
5;9;"03";2012;18153;9411;8742
5;9;"33";2012;83764;43183;40581
5;9;"95";2012;84718;43421;41297
5;9;"29";2012;54132;27717;26415
5;9;"83";2012;55396;28640;26756
5;9;"46";2012;9076;4678;4398
5;9;"10";2012;18517;9296;9221
5;9;"04";2012;9314;4824;4490
5;9;"34";2012;59387;30306;29081
5;9;"28";2012;28693;14687;14006
5;9;"90";2012;8718;4506;4212
5;9;"84";2012;33082;16830;16252
5;9;"47";2012;18254;9618;8636
5;9;"70";2012;15201;7808;7393
5;9;"64";2012;36074;18776;17298
5;9;"35";2012;64827;33328;31499
5;9;"972";2012;26410;13174;13236
5;9;"974";2012;71223;36404;34819
5;9;"54";2012;42712;21648;21064
5;9;"18";2012;17322;8876;8446
5;9;"71";2012;31813;16146;15667
5;9;"65";2012;12012;6244;5768
5;9;"971";2012;29284;15175;14109
5;9;"30";2012;43591;22042;21549
5;9;"66";2012;25921;13364;12557
5;9;"09";2012;8336;4259;4077
5;9;"11";2012;20284;10392;9892
5;9;"05";2012;8062;4136;3926
5;9;"48";2012;4226;2254;1972
5;9;"12";2012;14932;7825;7107
5;9;"06";2012;56010;28416;27594
5;9;"36";2012;12663;6457;6206
5;9;"973";2012;27708;14090;13618
5;9;"07";2012;19131;9926;9205
5;9;"19";2012;12547;6410;6137
5;9;"72";2012;36446;18550;17896
5;9;"13";2012;116985;59324;57661
5;9;"08";2012;18048;9358;8690
10;14;"73";2012;25899;13307;12592
10;14;"45";2012;40242;20645;19597
10;14;"44";2012;80597;41329;39268
10;14;"37";2012;34929;17783;17146
10;14;"79";2012;21925;11273;10652
10;14;"81";2012;21542;11132;10410
10;14;"43";2012;13726;7141;6585
10;14;"74";2012;47556;24631;22925
10;14;"61";2012;17854;9159;8695
10;14;"55";2012;11931;6232;5699
10;14;"75";2012;99049;50270;48779
10;14;"38";2012;77365;39819;37546
10;14;"82";2012;14989;7741;7248
10;14;"76";2012;77697;39659;38038
10;14;"39";2012;16409;8423;7986
10;14;"80";2012;34458;17865;16593
10;14;"25";2012;31917;16544;15373
10;14;"2A";2012;7723;4151;3572
10;14;"21";2012;30316;15724;14592
10;14;"83";2012;58283;30025;28258
10;14;"46";2012;9413;4777;4636
10;14;"40";2012;22636;11539;11097
10;14;"63";2012;33835;17416;16419
10;14;"26";2012;31113;16078;15035
10;14;"2B";2012;8500;4400;4100
10;14;"22";2012;35435;18138;17297
10;14;"84";2012;34102;17743;16359
10;14;"47";2012;19060;9880;9180
10;14;"62";2012;97097;50111;46986
10;14;"56";2012;44193;22741;21452
10;14;"27";2012;39719;20121;19598
10;14;"29";2012;53645;27780;25865
10;14;"23";2012;6201;3158;3043
10;14;"77";2012;92633;47238;45395
10;14;"48";2012;4104;2102;2002
10;14;"42";2012;44639;23015;21624
10;14;"57";2012;60391;31021;29370
10;14;"28";2012;26980;13753;13227
10;14;"30";2012;44222;22481;21741
10;14;"24";2012;22167;11433;10734
10;14;"78";2012;95930;49450;46480
10;14;"41";2012;19510;10148;9362
10;14;"64";2012;36738;18806;17932
10;14;"58";2012;11548;5948;5600
10;14;"60";2012;54218;27924;26294
10;14;"91";2012;81387;41469;39918
10;14;"85";2012;37636;19253;18383
10;14;"87";2012;19095;9748;9347
10;14;"50";2012;30730;15543;15187
10;14;"65";2012;12091;6257;5834
10;14;"59";2012;168712;86208;82504
10;14;"02";2012;35308;17979;17329
10;14;"92";2012;91208;46797;44411
10;14;"86";2012;23835;12049;11786
10;14;"49";2012;50098;25463;24635
10;14;"51";2012;33846;17435;16411
10;14;"66";2012;26194;13600;12594
10;14;"01";2012;40776;20706;20070
10;14;"31";2012;72445;37379;35066
10;14;"93";2012;99077;50513;48564
10;14;"95";2012;79955;40637;39318
10;14;"89";2012;21155;10999;10156
10;14;"52";2012;10839;5482;5357
10;14;"67";2012;65110;33314;31796
10;14;"69";2012;103124;52637;50487
10;14;"32";2012;10507;5369;5138
10;14;"94";2012;80594;41460;39134
10;14;"88";2012;23089;11886;11203
10;14;"90";2012;8474;4438;4036
10;14;"53";2012;19808;10146;9662
10;14;"68";2012;46831;23757;23074
10;14;"03";2012;18430;9311;9119
10;14;"33";2012;84532;42913;41619
10;14;"35";2012;62053;31821;30232
10;14;"972";2012;27636;14074;13562
10;14;"974";2012;70827;36292;34535
10;14;"16";2012;20008;10090;9918
10;14;"10";2012;18477;9236;9241
10;14;"04";2012;9462;4875;4587
10;14;"34";2012;60266;30852;29414
10;14;"971";2012;31683;16306;15377
10;14;"973";2012;24867;12843;12024
10;14;"07";2012;19040;9764;9276
10;14;"17";2012;34531;17716;16815
10;14;"70";2012;14793;7580;7213
10;14;"05";2012;8477;4270;4207
10;14;"18";2012;17536;8977;8559
10;14;"09";2012;8536;4457;4079
10;14;"06";2012;60040;31147;28893
10;14;"54";2012;42433;21916;20517
10;14;"72";2012;35213;17861;17352
10;14;"71";2012;31878;16637;15241
10;14;"12";2012;15071;7758;7313
10;14;"36";2012;12552;6494;6058
10;14;"08";2012;18256;9391;8865
10;14;"15";2012;7178;3710;3468
10;14;"11";2012;21207;10783;10424
10;14;"19";2012;12487;6403;6084
10;14;"13";2012;118925;60891;58034
10;14;"14";2012;42044;21516;20528
15;19;"73";2012;24350;12656;11694
15;19;"37";2012;37480;18421;19059
15;19;"43";2012;12250;6309;5941
15;19;"74";2012;44374;23285;21089
15;19;"79";2012;19308;10046;9262
15;19;"50";2012;28588;14955;13633
15;19;"49";2012;51108;25834;25274
15;19;"67";2012;70529;35551;34978
15;19;"51";2012;37028;19017;18011
15;19;"45";2012;39299;20434;18865
15;19;"44";2012;81922;41671;40251
15;19;"80";2012;37856;19226;18630
15;19;"85";2012;34453;18119;16334
15;19;"2A";2012;7589;4041;3548
15;19;"81";2012;21169;10881;10288
15;19;"75";2012;119707;57655;62052
15;19;"38";2012;79280;40780;38500
15;19;"61";2012;16686;8565;8121
15;19;"55";2012;10906;5635;5271
15;19;"86";2012;26579;13103;13476
15;19;"2B";2012;8235;4279;3956
15;19;"82";2012;13076;6805;6271
15;19;"76";2012;82403;41552;40851
15;19;"68";2012;44833;23213;21620
15;19;"31";2012;83190;42211;40979
15;19;"25";2012;33122;17018;16104
15;19;"87";2012;21374;10689;10685
15;19;"21";2012;35311;17535;17776
15;19;"52";2012;10296;5434;4862
15;19;"46";2012;9041;4708;4333
15;19;"69";2012;117937;58307;59630
15;19;"32";2012;9532;5054;4478
15;19;"26";2012;29211;15161;14050
15;19;"88";2012;22432;11721;10711
15;19;"22";2012;32282;16790;15492
15;19;"53";2012;17406;9205;8201
15;19;"39";2012;15060;7704;7356
15;19;"62";2012;93824;48233;45591
15;19;"56";2012;40861;21171;19690
15;19;"27";2012;35784;18303;17481
15;19;"89";2012;18762;9735;9027
15;19;"83";2012;56964;29455;27509
15;19;"77";2012;89364;45933;43431
15;19;"40";2012;19545;10253;9292
15;19;"63";2012;39309;19706;19603
15;19;"57";2012;62745;32446;30299
15;19;"28";2012;25067;13087;11980
15;19;"90";2012;9439;5166;4273
15;19;"84";2012;32780;16659;16121
15;19;"47";2012;17688;9202;8486
15;19;"70";2012;13425;6913;6512
15;19;"33";2012;92004;46423;45581
15;19;"58";2012;11322;5909;5413
15;19;"29";2012;52959;27456;25503
15;19;"23";2012;5981;3072;2909
15;19;"54";2012;49988;25412;24576
15;19;"48";2012;3922;2167;1755
15;19;"71";2012;30585;16230;14355
15;19;"34";2012;64680;32655;32025
15;19;"59";2012;177049;90137;86912
15;19;"30";2012;42777;21919;20858
15;19;"24";2012;20260;10468;9792
15;19;"78";2012;92123;46634;45489
15;19;"41";2012;18252;9413;8839
15;19;"64";2012;37872;19709;18163
15;19;"35";2012;64730;32661;32069
15;19;"60";2012;52036;26983;25053
15;19;"91";2012;79756;40797;38959
15;19;"93";2012;100739;50654;50085
15;19;"95";2012;82382;41804;40578
15;19;"42";2012;46403;23613;22790
15;19;"65";2012;12851;6735;6116
15;19;"36";2012;11845;6011;5834
15;19;"02";2012;33425;17295;16130
15;19;"92";2012;89217;44973;44244
15;19;"94";2012;80910;41238;39672
15;19;"971";2012;30792;15755;15037
15;19;"72";2012;33798;17413;16385
15;19;"66";2012;25010;13016;11994
15;19;"01";2012;36162;18535;17627
15;19;"03";2012;18123;9427;8696
15;19;"05";2012;7479;3939;3540
15;19;"07";2012;17301;8916;8385
15;19;"972";2012;29421;14763;14658
15;19;"974";2012;71254;35775;35479
15;19;"16";2012;19402;10100;9302
15;19;"10";2012;19083;10117;8966
15;19;"04";2012;9381;4993;4388
15;19;"06";2012;61306;31533;29773
15;19;"08";2012;16760;8893;7867
15;19;"973";2012;21401;10729;10672
15;19;"15";2012;6987;3675;3312
15;19;"17";2012;34710;18316;16394
15;19;"11";2012;19434;9971;9463
15;19;"13";2012;127420;65481;61939
15;19;"18";2012;17281;9086;8195
15;19;"09";2012;7760;4093;3667
15;19;"14";2012;45711;23025;22686
15;19;"19";2012;12754;7067;5687
15;19;"12";2012;14206;7499;6707
20;24;"49";2012;52172;26151;26021
20;24;"79";2012;18439;9700;8739
20;24;"73";2012;23571;12275;11296
20;24;"86";2012;31231;14926;16305
20;24;"80";2012;39940;20146;19794
20;24;"43";2012;10160;5387;4773
20;24;"55";2012;11124;5911;5213
20;24;"01";2012;31268;16330;14938
20;24;"91";2012;81878;42275;39603
20;24;"85";2012;30219;15700;14519
20;24;"87";2012;23268;11312;11956
20;24;"50";2012;24797;13058;11739
20;24;"44";2012;83754;42795;40959
20;24;"67";2012;77881;37965;39916
20;24;"61";2012;14567;7420;7147
20;24;"92";2012;102815;50298;52517
20;24;"57";2012;66785;34938;31847
20;24;"88";2012;20301;10658;9643
20;24;"74";2012;40126;21368;18758
20;24;"37";2012;41724;20275;21449
20;24;"68";2012;43555;22188;21367
20;24;"31";2012;102362;51209;51153
20;24;"56";2012;35480;18950;16530
20;24;"27";2012;32009;16365;15644
20;24;"81";2012;17764;9235;8529
20;24;"75";2012;190328;85544;104784
20;24;"38";2012;81012;42173;38839
20;24;"02";2012;31121;15952;15169
20;24;"32";2012;7533;3900;3633
20;24;"94";2012;93425;45126;48299
20;24;"28";2012;22403;11542;10861
20;24;"51";2012;41822;21248;20574
20;24;"45";2012;40452;20694;19758
20;24;"39";2012;13049;6881;6168
20;24;"62";2012;92536;47042;45494
20;24;"93";2012;110221;53693;56528
20;24;"58";2012;9905;5284;4621
20;24;"89";2012;16873;8532;8341
20;24;"52";2012;9855;5322;4533
20;24;"46";2012;6478;3479;2999
20;24;"69";2012;140148;68279;71869
20;24;"63";2012;41810;21226;20584
20;24;"34";2012;74794;36675;38119
20;24;"59";2012;195087;97711;97376
20;24;"82";2012;11541;5961;5580
20;24;"76";2012;85228;42648;42580
20;24;"47";2012;16023;8165;7858
20;24;"03";2012;15707;8085;7622
20;24;"33";2012;100635;49428;51207
20;24;"95";2012;83387;41680;41707
20;24;"29";2012;49258;25833;23425
20;24;"83";2012;52045;27203;24842
20;24;"77";2012;87854;44116;43738
20;24;"40";2012;16919;9166;7753
20;24;"04";2012;7098;3689;3409
20;24;"65";2012;11278;6140;5138
20;24;"971";2012;21089;10649;10440
20;24;"90";2012;9462;5490;3972
20;24;"53";2012;16494;8760;7734
20;24;"78";2012;86964;43822;43142
20;24;"70";2012;11677;6310;5367
20;24;"64";2012;34325;17676;16649
20;24;"35";2012;72112;35649;36463
20;24;"60";2012;48877;25316;23561
20;24;"974";2012;56332;28067;28265
20;24;"54";2012;58316;29294;29022
20;24;"48";2012;3659;1947;1712
20;24;"71";2012;26476;14178;12298
20;24;"06";2012;60079;30423;29656
20;24;"36";2012;10269;5390;4879
20;24;"30";2012;37009;19103;17906
20;24;"84";2012;30514;15345;15169
20;24;"14";2012;45287;22874;22413
20;24;"41";2012;15052;7772;7280
20;24;"05";2012;6045;3175;2870
20;24;"66";2012;22620;11303;11317
20;24;"972";2012;22587;11099;11488
20;24;"11";2012;17122;8895;8227
20;24;"13";2012;132695;66124;66571
20;24;"15";2012;6347;3384;2963
20;24;"42";2012;44568;22417;22151
20;24;"21";2012;37980;18606;19374
20;24;"08";2012;15823;8283;7540
20;24;"973";2012;16206;7728;8478
20;24;"12";2012;11939;6197;5742
20;24;"09";2012;6769;3531;3238
20;24;"19";2012;11651;6297;5354
20;24;"72";2012;31355;16281;15074
20;24;"07";2012;13916;7247;6669
20;24;"2A";2012;7752;3934;3818
20;24;"17";2012;30935;16111;14824
20;24;"2B";2012;10421;5443;4978
20;24;"10";2012;17845;9443;8402
20;24;"22";2012;27553;14540;13013
20;24;"25";2012;37432;18912;18520
20;24;"16";2012;17217;9187;8030
20;24;"23";2012;5023;2815;2208
20;24;"18";2012;15093;7850;7243
20;24;"26";2012;25765;13210;12555
20;24;"24";2012;18071;9205;8866
25;29;"39";2012;13767;6873;6894
25;29;"38";2012;74545;37376;37169
25;29;"37";2012;34584;17150;17434
25;29;"55";2012;11668;6075;5593
25;29;"41";2012;16113;8266;7847
25;29;"40";2012;18963;9647;9316
25;29;"76";2012;80067;39635;40432
25;29;"78";2012;88270;43353;44917
25;29;"75";2012;223970;107219;116751
25;29;"77";2012;88429;42802;45627
25;29;"79";2012;19768;9869;9899
25;29;"42";2012;42609;21380;21229
25;29;"86";2012;26223;12731;13492
25;29;"49";2012;47403;23721;23682
25;29;"74";2012;47467;24049;23418
25;29;"92";2012;122423;59180;63243
25;29;"73";2012;24183;12335;11848
25;29;"91";2012;80162;39718;40444
25;29;"56";2012;36926;18855;18071
25;29;"87";2012;21001;10509;10492
25;29;"50";2012;26099;13297;12802
25;29;"57";2012;69053;35120;33933
25;29;"85";2012;35327;17961;17366
25;29;"61";2012;15160;7707;7453
25;29;"32";2012;8015;4008;4007
25;29;"94";2012;99102;47136;51966
25;29;"80";2012;35448;17795;17653
25;29;"43";2012;10981;5538;5443
25;29;"58";2012;10171;5217;4954
25;29;"60";2012;50673;25149;25524
25;29;"31";2012;92082;47129;44953
25;29;"93";2012;116386;55373;61013
25;29;"27";2012;34361;16667;17694
25;29;"81";2012;18236;9094;9142
25;29;"44";2012;80503;40237;40266
25;29;"59";2012;177766;88596;89170
25;29;"02";2012;31971;16015;15956
25;29;"63";2012;37743;18947;18796
25;29;"34";2012;63773;31253;32520
25;29;"88";2012;20652;10328;10324
25;29;"51";2012;37293;18830;18463
25;29;"45";2012;40582;20238;20344
25;29;"01";2012;34961;17622;17339
25;29;"62";2012;91170;45322;45848
25;29;"33";2012;91781;45284;46497
25;29;"95";2012;80538;39439;41099
25;29;"89";2012;18456;9060;9396
25;29;"52";2012;10169;5259;4910
25;29;"67";2012;73268;35837;37431
25;29;"69";2012;126776;61551;65225
25;29;"04";2012;7451;3617;3834
25;29;"65";2012;10904;5552;5352
25;29;"28";2012;25123;12456;12667
25;29;"82";2012;12693;6387;6306
25;29;"53";2012;17353;8723;8630
25;29;"68";2012;45917;22693;23224
25;29;"03";2012;16466;8412;8054
25;29;"64";2012;35031;17656;17375
25;29;"35";2012;65030;32710;32320
25;29;"29";2012;48888;25108;23780
25;29;"83";2012;51894;26116;25778
25;29;"46";2012;7401;3679;3722
25;29;"10";2012;17769;8804;8965
25;29;"71";2012;28096;14276;13820
25;29;"06";2012;59824;29733;30091
25;29;"971";2012;18090;7826;10264
25;29;"90";2012;9329;4800;4529
25;29;"84";2012;29938;14707;15231
25;29;"47";2012;16598;8168;8430
25;29;"70";2012;12776;6321;6455
25;29;"05";2012;7137;3639;3498
25;29;"66";2012;23539;11353;12186
25;29;"972";2012;18188;7989;10199
25;29;"974";2012;50540;22922;27618
25;29;"54";2012;48965;24697;24268
25;29;"48";2012;3943;2014;1929
25;29;"12";2012;13331;6698;6633
25;29;"14";2012;40434;20007;20427
25;29;"36";2012;11009;5385;5624
25;29;"30";2012;36822;17807;19015
25;29;"2A";2012;7952;3923;4029
25;29;"09";2012;7310;3576;3734
25;29;"11";2012;17717;8714;9003
25;29;"72";2012;31561;15753;15808
25;29;"07";2012;15369;7658;7711
25;29;"15";2012;7213;3595;3618
25;29;"19";2012;11915;6150;5765
25;29;"2B";2012;10497;5420;5077
25;29;"973";2012;16390;7281;9109
25;29;"18";2012;15653;7888;7765
25;29;"21";2012;32624;16398;16226
25;29;"08";2012;15861;7884;7977
25;29;"13";2012;121368;59432;61936
25;29;"23";2012;5000;2554;2446
25;29;"17";2012;30052;15069;14983
25;29;"26";2012;26394;13069;13325
25;29;"16";2012;17931;8948;8983
25;29;"22";2012;28803;14420;14383
25;29;"24";2012;18431;9170;9261
25;29;"25";2012;35499;18108;17391
30;34;"37";2012;32409;16098;16311
30;34;"38";2012;75176;37425;37751
30;34;"61";2012;14829;7365;7464
30;34;"39";2012;14115;7005;7110
30;34;"44";2012;80170;40129;40041
30;34;"43";2012;12006;6003;6003
30;34;"45";2012;39440;19765;19675
30;34;"55";2012;11065;5795;5270
30;34;"47";2012;16242;8057;8185
30;34;"46";2012;8029;3893;4136
30;34;"40";2012;20335;9910;10425
30;34;"76";2012;72114;35802;36312
30;34;"73";2012;24965;12644;12321
30;34;"62";2012;87549;43145;44404
30;34;"74";2012;49217;24342;24875
30;34;"48";2012;4210;2072;2138
30;34;"63";2012;36361;18577;17784
30;34;"75";2012;194927;97638;97289
30;34;"77";2012;87639;42820;44819
30;34;"82";2012;13907;6793;7114
30;34;"84";2012;29912;14609;15303
30;34;"78";2012;91128;45341;45787
30;34;"41";2012;17272;8369;8903
30;34;"56";2012;39063;19560;19503
30;34;"79";2012;20276;10106;10170
30;34;"81";2012;19831;9815;10016
30;34;"83";2012;51332;25624;25708
30;34;"85";2012;36718;18669;18049
30;34;"87";2012;20684;10314;10370
30;34;"42";2012;41252;20954;20298
30;34;"57";2012;63846;32292;31554
30;34;"80";2012;33692;16760;16932
30;34;"02";2012;30271;15063;15208
30;34;"92";2012;126243;61615;64628
30;34;"86";2012;23997;11853;12144
30;34;"49";2012;46445;23226;23219
30;34;"64";2012;35709;17724;17985
30;34;"58";2012;10022;4881;5141
30;34;"60";2012;50763;25226;25537
30;34;"91";2012;79891;39912;39979
30;34;"93";2012;115233;56572;58661
30;34;"27";2012;35076;17275;17801
30;34;"50";2012;25766;12914;12852
30;34;"65";2012;11088;5509;5579
30;34;"59";2012;162454;80645;81809
30;34;"69";2012;115114;57629;57485
30;34;"04";2012;7813;3827;3986
30;34;"94";2012;97700;47659;50041
30;34;"88";2012;20332;10220;10112
30;34;"51";2012;33383;16895;16488
30;34;"66";2012;23692;11435;12257
30;34;"01";2012;36281;18017;18264
30;34;"03";2012;16793;8202;8591
30;34;"33";2012;89292;44444;44848
30;34;"95";2012;79735;38118;41617
30;34;"89";2012;18368;9132;9236
30;34;"52";2012;9458;4776;4682
30;34;"67";2012;68065;33875;34190
30;34;"10";2012;17156;8454;8702
30;34;"71";2012;28089;14173;13916
30;34;"34";2012;60618;29768;30850
30;34;"28";2012;25575;12550;13025
30;34;"90";2012;8810;4535;4275
30;34;"53";2012;17690;9005;8685
30;34;"68";2012;44939;22372;22567
30;34;"70";2012;13303;6646;6657
30;34;"05";2012;7166;3382;3784
30;34;"35";2012;62869;32190;30679
30;34;"29";2012;49972;25488;24484
30;34;"31";2012;83596;42982;40614
30;34;"16";2012;18065;8984;9081
30;34;"18";2012;15360;7751;7609
30;34;"12";2012;13961;7153;6808
30;34;"06";2012;61110;29267;31843
30;34;"971";2012;21380;8654;12726
30;34;"30";2012;38477;18741;19736
30;34;"32";2012;8749;4250;4499
30;34;"17";2012;31273;15341;15932
30;34;"11";2012;18476;9130;9346
30;34;"72";2012;32023;16119;15904
30;34;"07";2012;16472;8071;8401
30;34;"972";2012;19910;8326;11584
30;34;"974";2012;55239;24936;30303
30;34;"54";2012;43071;21743;21328
30;34;"973";2012;16368;7692;8676
30;34;"2A";2012;7658;3776;3882
30;34;"14";2012;38721;19165;19556
30;34;"36";2012;11701;6025;5676
30;34;"13";2012;115993;55966;60027
30;34;"15";2012;7419;3759;3660
30;34;"09";2012;7974;3949;4025
30;34;"19";2012;12246;6268;5978
30;34;"08";2012;16137;7895;8242
30;34;"25";2012;32500;16477;16023
30;34;"22";2012;30004;14990;15014
30;34;"26";2012;26686;12934;13752
30;34;"2B";2012;9712;4878;4834
30;34;"21";2012;30486;15333;15153
30;34;"23";2012;5463;2697;2766
30;34;"24";2012;19444;9475;9969
35;39;"67";2012;78657;39204;39453
35;39;"37";2012;39637;19909;19728
35;39;"44";2012;91973;46307;45666
35;39;"61";2012;18046;9115;8931
35;39;"68";2012;53880;26923;26957
35;39;"43";2012;15124;7600;7524
35;39;"74";2012;57075;28512;28563
35;39;"45";2012;45661;22690;22971
35;39;"73";2012;29688;14987;14701
35;39;"38";2012;87062;43515;43547
35;39;"46";2012;10506;5189;5317
35;39;"69";2012;118991;59283;59708
35;39;"55";2012;12728;6519;6209
35;39;"75";2012;178608;90591;88017
35;39;"49";2012;52934;26430;26504
35;39;"51";2012;38714;19222;19492
35;39;"76";2012;83282;41135;42147
35;39;"39";2012;17525;8610;8915
35;39;"62";2012;101018;50442;50576
35;39;"85";2012;42450;21295;21155
35;39;"79";2012;24815;12405;12410
35;39;"50";2012;31607;15806;15801
35;39;"52";2012;11480;5766;5714
35;39;"77";2012;100722;49210;51512
35;39;"40";2012;26736;13160;13576
35;39;"63";2012;42791;21521;21270
35;39;"86";2012;27901;13820;14081
35;39;"80";2012;39284;19536;19748
35;39;"82";2012;16960;8471;8489
35;39;"53";2012;20420;10437;9983
35;39;"47";2012;20595;10115;10480
35;39;"70";2012;16696;8468;8228
35;39;"56";2012;48621;24272;24349
35;39;"87";2012;24796;12139;12657
35;39;"81";2012;24366;12025;12341
35;39;"83";2012;64850;31319;33531
35;39;"54";2012;49026;24587;24439
35;39;"48";2012;5179;2612;2567
35;39;"71";2012;35359;17531;17828
35;39;"57";2012;71691;36051;35640
35;39;"88";2012;24691;12453;12238
35;39;"90";2012;9882;5115;4767
35;39;"84";2012;35576;17447;18129
35;39;"78";2012;104426;51906;52520
35;39;"41";2012;21805;10823;10982
35;39;"64";2012;43741;21668;22073
35;39;"58";2012;12711;6324;6387
35;39;"89";2012;22396;11050;11346
35;39;"91";2012;89336;44022;45314
35;39;"93";2012;114374;57279;57095
35;39;"27";2012;42303;21022;21281
35;39;"42";2012;49044;24596;24448
35;39;"65";2012;14315;7121;7194
35;39;"59";2012;178362;89020;89342
35;39;"02";2012;36557;18235;18322
35;39;"92";2012;129196;64062;65134
35;39;"94";2012;100425;49601;50824
35;39;"28";2012;30350;15212;15138
35;39;"72";2012;38465;19152;19313
35;39;"66";2012;29109;13975;15134
35;39;"60";2012;59224;29460;29764
35;39;"03";2012;21449;10772;10677
35;39;"33";2012;104058;51609;52449
35;39;"95";2012;84181;41403;42778
35;39;"29";2012;60664;31111;29553
35;39;"21";2012;35113;17484;17629
35;39;"16";2012;22466;11061;11405
35;39;"10";2012;19968;9938;10030
35;39;"04";2012;10116;4886;5230
35;39;"34";2012;68863;33783;35080
35;39;"971";2012;29401;12372;17029
35;39;"30";2012;47156;22867;24289
35;39;"22";2012;38446;19274;19172
35;39;"01";2012;44938;22355;22583
35;39;"11";2012;23295;11420;11875
35;39;"05";2012;9038;4569;4469
35;39;"35";2012;70506;35652;34854
35;39;"972";2012;27580;11585;15995
35;39;"31";2012;90520;45478;45042
35;39;"23";2012;7217;3690;3527
35;39;"18";2012;19994;9991;10003
35;39;"12";2012;17469;8726;8743
35;39;"06";2012;71372;34614;36758
35;39;"36";2012;14572;7342;7230
35;39;"973";2012;16742;7877;8865
35;39;"32";2012;11786;5767;6019
35;39;"17";2012;39500;19627;19873
35;39;"19";2012;15265;7677;7588
35;39;"13";2012;134688;65905;68783
35;39;"07";2012;20852;10405;10447
35;39;"09";2012;9803;4822;4981
35;39;"974";2012;60586;28029;32557
35;39;"08";2012;19164;9636;9528
35;39;"25";2012;36089;18252;17837
35;39;"2A";2012;9981;4746;5235
35;39;"14";2012;45360;22595;22765
35;39;"26";2012;32419;15962;16457
35;39;"2B";2012;11449;5692;5757
35;39;"15";2012;9432;4705;4727
35;39;"24";2012;25165;12461;12704
40;44;"73";2012;30535;15255;15280
40;44;"86";2012;27707;13449;14258
40;44;"49";2012;52048;26056;25992
40;44;"85";2012;42013;21140;20873
40;44;"79";2012;25219;12642;12577
40;44;"50";2012;33513;16848;16665
40;44;"75";2012;154892;77059;77833
40;44;"67";2012;80688;40562;40126
40;44;"61";2012;19230;9720;9510
40;44;"55";2012;13041;6557;6484
40;44;"57";2012;74819;37467;37352
40;44;"80";2012;39023;19594;19429
40;44;"74";2012;58041;28992;29049
40;44;"45";2012;44700;22370;22330
40;44;"01";2012;46098;23296;22802
40;44;"91";2012;89130;44035;45095
40;44;"56";2012;49298;25074;24224
40;44;"87";2012;24623;12295;12328
40;44;"81";2012;25776;12749;13027
40;44;"52";2012;12295;6257;6038
40;44;"46";2012;11448;5649;5799
40;44;"02";2012;36489;18163;18326
40;44;"92";2012;115856;55944;59912
40;44;"94";2012;94702;46274;48428
40;44;"88";2012;26076;13113;12963
40;44;"51";2012;38599;18996;19603
40;44;"76";2012;83439;40969;42470
40;44;"68";2012;56283;28275;28008
40;44;"62";2012;97969;48924;49045
40;44;"93";2012;106997;53101;53896
40;44;"58";2012;13592;6719;6873
40;44;"89";2012;23274;11620;11654
40;44;"83";2012;68724;33111;35613
40;44;"77";2012;99267;48834;50433
40;44;"69";2012;115390;57067;58323
40;44;"63";2012;43027;21537;21490
40;44;"65";2012;15335;7522;7813
40;44;"59";2012;170314;84418;85896
40;44;"82";2012;16831;8415;8416
40;44;"53";2012;20801;10607;10194
40;44;"47";2012;22170;10843;11327
40;44;"03";2012;22797;11460;11337
40;44;"64";2012;46274;22936;23338
40;44;"95";2012;83270;40246;43024
40;44;"60";2012;59098;29584;29514
40;44;"974";2012;67780;32311;35469
40;44;"54";2012;48019;23501;24518
40;44;"48";2012;5150;2696;2454
40;44;"04";2012;11246;5486;5760
40;44;"06";2012;75312;36206;39106
40;44;"971";2012;32077;13848;18229
40;44;"90";2012;9807;5045;4762
40;44;"84";2012;38493;18630;19863
40;44;"78";2012;103452;50737;52715
40;44;"70";2012;16689;8585;8104
40;44;"05";2012;9801;4916;4885
40;44;"66";2012;30273;14546;15727
40;44;"972";2012;32091;14036;18055
40;44;"39";2012;18672;9369;9303
40;44;"33";2012;101617;49654;51963
40;44;"27";2012;42179;21102;21077
40;44;"71";2012;37769;18759;19010
40;44;"21";2012;35060;17294;17766
40;44;"08";2012;19951;9972;9979
40;44;"973";2012;15065;7415;7650
40;44;"40";2012;27650;13937;13713
40;44;"34";2012;70594;34155;36439
40;44;"28";2012;29940;15022;14918
40;44;"72";2012;38344;19227;19117
40;44;"07";2012;22487;11330;11157
40;44;"09";2012;10321;5099;5222
40;44;"11";2012;24357;11960;12397
40;44;"41";2012;22775;11450;11325
40;44;"35";2012;68763;34428;34335
40;44;"29";2012;60431;30426;30005
40;44;"31";2012;88804;44295;44509
40;44;"16";2012;24066;12010;12056
40;44;"10";2012;20351;10220;10131
40;44;"12";2012;18771;9540;9231
40;44;"42";2012;49006;24585;24421
40;44;"36";2012;15711;7814;7897
40;44;"30";2012;50262;24445;25817
40;44;"22";2012;38945;19538;19407
40;44;"17";2012;40715;19950;20765
40;44;"19";2012;16086;8054;8032
40;44;"13";2012;137941;66558;71383
40;44;"43";2012;15866;8158;7708
40;44;"37";2012;40101;19793;20308
40;44;"14";2012;45143;22521;22622
40;44;"23";2012;7873;4028;3845
40;44;"18";2012;20821;10270;10551
40;44;"2A";2012;10784;5197;5587
40;44;"24";2012;27349;13410;13939
40;44;"44";2012;88795;44180;44615
40;44;"38";2012;86485;43182;43303
40;44;"32";2012;12920;6417;6503
40;44;"26";2012;34714;17113;17601
40;44;"2B";2012;12005;5983;6022
40;44;"15";2012;10039;5161;4878
40;44;"25";2012;36126;18157;17969
45;49;"55";2012;13698;7024;6674
45;49;"79";2012;26344;13188;13156
45;49;"50";2012;35512;18059;17453
45;49;"57";2012;79686;39383;40303
45;49;"74";2012;55084;27316;27768
45;49;"76";2012;85053;41736;43317
45;49;"78";2012;102809;50211;52598
45;49;"49";2012;52478;25855;26623
45;49;"56";2012;50620;25337;25283
45;49;"58";2012;14824;7277;7547
45;49;"73";2012;30225;15161;15064
45;49;"75";2012;145302;69708;75594
45;49;"77";2012;95710;47511;48199
45;49;"87";2012;25357;12495;12862
45;49;"81";2012;26372;12975;13397
45;49;"52";2012;13322;6605;6717
45;49;"59";2012;169633;83073;86560
45;49;"61";2012;19943;9915;10028
45;49;"92";2012;106783;50722;56061
45;49;"86";2012;28191;14004;14187
45;49;"80";2012;38092;18949;19143
45;49;"51";2012;38515;19148;19367
45;49;"45";2012;44197;21660;22537
45;49;"60";2012;58091;29178;28913
45;49;"91";2012;87956;43277;44679
45;49;"85";2012;43116;21498;21618
45;49;"27";2012;41406;20587;20819
45;49;"89";2012;23404;11636;11768
45;49;"83";2012;70008;33499;36509
45;49;"67";2012;80977;40131;40846
45;49;"02";2012;37959;18953;19006
45;49;"63";2012;43555;21449;22106
45;49;"94";2012;94301;45570;48731
45;49;"88";2012;27161;13415;13746
45;49;"82";2012;17391;8619;8772
45;49;"53";2012;20726;10391;10335
45;49;"01";2012;44103;22259;21844
45;49;"62";2012;101036;50369;50667
45;49;"93";2012;104788;51432;53356
45;49;"95";2012;84629;40915;43714
45;49;"29";2012;62696;31484;31212
45;49;"31";2012;88152;43721;44431
45;49;"46";2012;12446;6122;6324
45;49;"69";2012;112676;54740;57936
45;49;"04";2012;11944;5771;6173
45;49;"65";2012;16549;7965;8584
45;49;"28";2012;29484;14750;14734
45;49;"90";2012;9827;4928;4899
45;49;"84";2012;38282;18519;19763
45;49;"68";2012;56435;28336;28099
45;49;"03";2012;23483;11700;11783
45;49;"64";2012;47532;23223;24309
45;49;"66";2012;30577;14830;15747
45;49;"972";2012;33120;15044;18076
45;49;"974";2012;62291;30352;31939
45;49;"54";2012;49784;24318;25466
45;49;"10";2012;21315;10468;10847
45;49;"71";2012;38790;19440;19350
45;49;"06";2012;76400;36585;39815
45;49;"971";2012;32798;15179;17619
45;49;"30";2012;50518;24435;26083
45;49;"32";2012;13773;6834;6939
45;49;"47";2012;23002;11168;11834
45;49;"70";2012;17034;8448;8586
45;49;"05";2012;10137;4935;5202
45;49;"07";2012;22437;11275;11162
45;49;"09";2012;11135;5513;5622
45;49;"39";2012;18334;9108;9226
45;49;"33";2012;98997;47816;51181
45;49;"48";2012;5463;2848;2615
45;49;"12";2012;19282;9823;9459
45;49;"14";2012;45508;22295;23213
45;49;"08";2012;20256;10211;10045
45;49;"973";2012;13280;6698;6582
45;49;"40";2012;27613;13816;13797
45;49;"34";2012;69801;33168;36633
45;49;"11";2012;24343;11930;12413
45;49;"72";2012;38491;19335;19156
45;49;"15";2012;10917;5545;5372
45;49;"17";2012;41234;19978;21256
45;49;"19";2012;17137;8588;8549
45;49;"41";2012;22380;11174;11206
45;49;"35";2012;66672;33326;33346
45;49;"37";2012;40018;19540;20478
45;49;"21";2012;36119;17848;18271
45;49;"16";2012;24993;12272;12721
45;49;"18";2012;22036;10975;11061
45;49;"2A";2012;11141;5384;5757
45;49;"42";2012;48849;23849;25000
45;49;"36";2012;16019;7971;8048
45;49;"13";2012;137445;65847;71598
45;49;"22";2012;39370;19702;19668
45;49;"24";2012;28934;14290;14644
45;49;"26";2012;34606;16887;17719
45;49;"2B";2012;12110;5949;6161
45;49;"43";2012;15532;7953;7579
45;49;"23";2012;8728;4343;4385
45;49;"25";2012;35097;17510;17587
45;49;"44";2012;87769;43452;44317
45;49;"38";2012;83945;41907;42038
50;54;"61";2012;20339;10167;10172
50;54;"55";2012;13745;6907;6838
50;54;"74";2012;48577;23774;24803
50;54;"76";2012;85367;41473;43894
50;54;"56";2012;50238;24796;25442
50;54;"79";2012;25735;12784;12951
50;54;"73";2012;28455;14283;14172
50;54;"75";2012;133530;63457;70073
50;54;"77";2012;89018;43804;45214
50;54;"87";2012;25311;12342;12969
50;54;"63";2012;43933;21457;22476
50;54;"57";2012;77260;37932;39328
50;54;"80";2012;37543;18131;19412
50;54;"82";2012;16436;8081;8355
50;54;"84";2012;36204;17121;19083
50;54;"78";2012;93433;44933;48500
50;54;"62";2012;100588;49587;51001
50;54;"64";2012;45368;22151;23217
50;54;"58";2012;16085;7800;8285
50;54;"81";2012;25669;12508;13161
50;54;"83";2012;67772;32891;34881
50;54;"85";2012;41876;21015;20861
50;54;"27";2012;40667;20002;20665
50;54;"89";2012;23661;11676;11985
50;54;"65";2012;16634;8018;8616
50;54;"59";2012;167330;81135;86195
50;54;"02";2012;37643;18671;18972
50;54;"92";2012;94431;43952;50479
50;54;"86";2012;29126;14383;14743
50;54;"88";2012;27298;13427;13871
50;54;"51";2012;37905;18156;19749
50;54;"66";2012;29101;13869;15232
50;54;"60";2012;54242;26407;27835
50;54;"91";2012;79464;39101;40363
50;54;"93";2012;96686;47003;49683
50;54;"95";2012;79041;37939;41102
50;54;"29";2012;62348;31126;31222
50;54;"52";2012;13117;6429;6688
50;54;"67";2012;76939;37954;38985
50;54;"69";2012;100980;48373;52607
50;54;"04";2012;11495;5650;5845
50;54;"94";2012;84760;40422;44338
50;54;"28";2012;29254;14267;14987
50;54;"90";2012;9600;4747;4853
50;54;"45";2012;42997;20817;22180
50;54;"01";2012;39879;19754;20125
50;54;"03";2012;24377;11836;12541
50;54;"33";2012;96477;46597;49880
50;54;"35";2012;62138;30784;31354
50;54;"972";2012;28690;13186;15504
50;54;"31";2012;78632;38591;40041
50;54;"16";2012;25610;12465;13145
50;54;"10";2012;20389;10050;10339
50;54;"71";2012;38872;19105;19767
50;54;"34";2012;65957;31086;34871
50;54;"971";2012;27579;13007;14572
50;54;"30";2012;48981;23419;25562
50;54;"53";2012;19868;10068;9800
50;54;"68";2012;53397;26400;26997
50;54;"70";2012;16926;8419;8507
50;54;"05";2012;10026;4959;5067
50;54;"07";2012;21604;10704;10900
50;54;"37";2012;39937;19554;20383
50;54;"974";2012;49960;24261;25699
50;54;"46";2012;12838;6231;6607
50;54;"18";2012;22026;10931;11095
50;54;"12";2012;19057;9556;9501
50;54;"06";2012;69413;33052;36361
50;54;"36";2012;16541;8329;8212
50;54;"973";2012;10545;5397;5148
50;54;"32";2012;13724;6669;7055
50;54;"17";2012;42623;20623;22000
50;54;"11";2012;23900;11465;12435
50;54;"72";2012;38072;18878;19194
50;54;"15";2012;10865;5522;5343
50;54;"09";2012;10860;5405;5455
50;54;"39";2012;17783;8877;8906
50;54;"54";2012;49035;23665;25370
50;54;"48";2012;5589;2895;2694
50;54;"2A";2012;10133;5090;5043
50;54;"14";2012;46343;22453;23890
50;54;"08";2012;19956;9970;9986
50;54;"38";2012;77542;38027;39515
50;54;"40";2012;26283;12913;13370
50;54;"47";2012;22539;10825;11714
50;54;"19";2012;17221;8557;8664
50;54;"13";2012;129280;61637;67643
50;54;"22";2012;40702;20323;20379
50;54;"24";2012;29875;14595;15280
50;54;"26";2012;33183;16411;16772
50;54;"41";2012;22250;10873;11377
50;54;"43";2012;15756;7953;7803
50;54;"50";2012;35090;17846;17244
50;54;"21";2012;35751;17577;18174
50;54;"23";2012;9216;4617;4599
50;54;"25";2012;33965;16448;17517
50;54;"42";2012;48538;23570;24968
50;54;"49";2012;50810;24979;25831
50;54;"2B";2012;11225;5683;5542
50;54;"44";2012;82403;40362;42041
55;59;"74";2012;45996;22469;23527
55;59;"85";2012;43151;21339;21812
55;59;"79";2012;25307;12555;12752
55;59;"73";2012;26983;13341;13642
55;59;"67";2012;72697;36508;36189
55;59;"61";2012;20825;10346;10479
55;59;"55";2012;14014;7069;6945
55;59;"75";2012;132033;61116;70917
55;59;"80";2012;38088;18718;19370
55;59;"82";2012;16469;8269;8200
55;59;"76";2012;82883;40088;42795
55;59;"86";2012;28989;14291;14698
55;59;"62";2012;98151;47845;50306
55;59;"56";2012;49880;24221;25659
55;59;"87";2012;26891;13118;13773
55;59;"81";2012;26223;12692;13531
55;59;"83";2012;66868;31622;35246
55;59;"77";2012;82587;40155;42432
55;59;"69";2012;97256;45802;51454
55;59;"63";2012;45198;22119;23079
55;59;"57";2012;72473;35926;36547
55;59;"88";2012;27212;13574;13638
55;59;"90";2012;9245;4449;4796
55;59;"84";2012;36313;17709;18604
55;59;"68";2012;51587;25730;25857
55;59;"70";2012;17113;8621;8492
55;59;"64";2012;45039;21726;23313
55;59;"58";2012;17411;8539;8872
55;59;"89";2012;24889;12344;12545
55;59;"91";2012;72547;35264;37283
55;59;"93";2012;89057;44120;44937
55;59;"27";2012;39515;19648;19867
55;59;"71";2012;40392;19901;20491
55;59;"65";2012;17005;8324;8681
55;59;"59";2012;160133;76680;83453
55;59;"02";2012;37778;18772;19006
55;59;"92";2012;88753;41432;47321
55;59;"78";2012;88805;42700;46105
55;59;"28";2012;29155;14456;14699
55;59;"72";2012;37451;18572;18879
55;59;"66";2012;29540;13828;15712
55;59;"60";2012;53773;26564;27209
55;59;"03";2012;25726;12507;13219
55;59;"33";2012;95051;45041;50010
55;59;"95";2012;73626;36170;37456
55;59;"29";2012;61044;30217;30827
55;59;"21";2012;35460;17290;18170
55;59;"16";2012;26227;12806;13421
55;59;"10";2012;21011;10322;10689
55;59;"04";2012;11337;5683;5654
55;59;"94";2012;79290;37488;41802
55;59;"971";2012;24015;10979;13036
55;59;"51";2012;38223;18296;19927
55;59;"45";2012;43095;21257;21838
55;59;"01";2012;37821;19009;18812
55;59;"39";2012;17592;8780;8812
55;59;"05";2012;9757;4889;4868
55;59;"35";2012;58686;28716;29970
55;59;"972";2012;24930;11376;13554
55;59;"52";2012;13328;6622;6706
55;59;"46";2012;13329;6592;6737
55;59;"18";2012;22585;10922;11663
55;59;"40";2012;27344;13311;14033
55;59;"34";2012;66396;31585;34811
55;59;"36";2012;17005;8518;8487
55;59;"30";2012;48472;23971;24501
55;59;"22";2012;41588;20389;21199
55;59;"17";2012;44991;21498;23493
55;59;"11";2012;24804;12202;12602
55;59;"41";2012;23482;11494;11988
55;59;"07";2012;22313;11054;11259
55;59;"37";2012;38912;18865;20047
55;59;"31";2012;74293;35811;38482
55;59;"23";2012;9585;4888;4697
55;59;"48";2012;5994;3195;2799
55;59;"12";2012;19783;9910;9873
55;59;"06";2012;68761;32448;36313
55;59;"08";2012;19761;9789;9972
55;59;"973";2012;8314;4207;4107
55;59;"53";2012;19760;9861;9899
55;59;"47";2012;23959;11772;12187
55;59;"19";2012;17716;8655;9061
55;59;"13";2012;126491;59707;66784
55;59;"43";2012;15649;8013;7636
55;59;"09";2012;11038;5655;5383
55;59;"974";2012;42397;20577;21820
55;59;"54";2012;48146;23476;24670
55;59;"25";2012;33187;16107;17080
55;59;"2A";2012;9711;4937;4774
55;59;"42";2012;49945;24305;25640
55;59;"44";2012;81696;39230;42466
55;59;"38";2012;74423;36323;38100
55;59;"32";2012;14252;7189;7063
55;59;"24";2012;31325;15310;16015
55;59;"49";2012;49586;24567;25019
55;59;"2B";2012;11451;5723;5728
55;59;"15";2012;11433;5833;5600
55;59;"50";2012;34396;17279;17117
55;59;"14";2012;47491;23293;24198
55;59;"26";2012;32326;15772;16554
60;64;"75";2012;125940;57852;68088
60;64;"85";2012;43850;21554;22296
60;64;"79";2012;23405;11507;11898
60;64;"73";2012;24887;12109;12778
60;64;"86";2012;25981;12798;13183
60;64;"80";2012;35102;17133;17969
60;64;"74";2012;42050;20353;21697
60;64;"92";2012;79176;37513;41663
60;64;"01";2012;34017;17061;16956
60;64;"91";2012;63779;31347;32432
60;64;"93";2012;69958;36078;33880
60;64;"87";2012;26285;12769;13516
60;64;"81";2012;25681;12412;13269
60;64;"83";2012;72466;34214;38252
60;64;"67";2012;58569;29203;29366
60;64;"02";2012;33246;16560;16686
60;64;"63";2012;42186;20489;21697
60;64;"94";2012;67180;32141;35039
60;64;"88";2012;25868;12880;12988
60;64;"82";2012;15103;7512;7591
60;64;"76";2012;74441;35698;38743
60;64;"68";2012;42162;21455;20707
60;64;"03";2012;24906;12229;12677
60;64;"64";2012;42169;20186;21983
60;64;"95";2012;59107;29058;30049
60;64;"89";2012;23749;11853;11896
60;64;"974";2012;31315;15588;15727
60;64;"77";2012;70322;35479;34843
60;64;"69";2012;91713;44361;47352
60;64;"04";2012;11677;5599;6078
60;64;"65";2012;16276;7901;8375
60;64;"971";2012;21626;9991;11635
60;64;"90";2012;8534;4326;4208
60;64;"84";2012;35121;17008;18113
60;64;"78";2012;78216;38585;39631
60;64;"70";2012;16210;8213;7997
60;64;"05";2012;9418;4746;4672
60;64;"66";2012;31807;14825;16982
60;64;"972";2012;21653;10057;11596
60;64;"39";2012;17332;8580;8752
60;64;"33";2012;88020;42025;45995
60;64;"27";2012;35857;17789;18068
60;64;"71";2012;38831;19019;19812
60;64;"06";2012;70090;32465;37625
60;64;"08";2012;17646;8810;8836
60;64;"973";2012;5615;2931;2684
60;64;"40";2012;27581;13256;14325
60;64;"34";2012;67344;31883;35461
60;64;"57";2012;58776;28889;29887
60;64;"72";2012;33895;16637;17258
60;64;"07";2012;22255;10865;11390
60;64;"09";2012;10677;5318;5359
60;64;"11";2012;25875;12484;13391
60;64;"41";2012;22177;10975;11202
60;64;"35";2012;53700;25536;28164
60;64;"58";2012;16907;8411;8496
60;64;"21";2012;32725;15845;16880
60;64;"16";2012;24273;11916;12357
60;64;"10";2012;19667;9763;9904
60;64;"12";2012;19408;9670;9738
60;64;"42";2012;48912;23920;24992
60;64;"28";2012;26425;13045;13380
60;64;"51";2012;34592;16960;17632
60;64;"45";2012;40228;19678;20550
60;64;"17";2012;47294;22749;24545
60;64;"19";2012;17408;8517;8891
60;64;"13";2012;118023;55909;62114
60;64;"43";2012;15395;7768;7627
60;64;"29";2012;58618;28113;30505
60;64;"52";2012;12514;6316;6198
60;64;"46";2012;13863;6910;6953
60;64;"18";2012;22667;11087;11580
60;64;"2A";2012;9044;4432;4612
60;64;"14";2012;42655;20450;22205
60;64;"36";2012;16663;8272;8391
60;64;"59";2012;142855;68207;74648
60;64;"22";2012;42302;20514;21788
60;64;"47";2012;23470;11355;12115
60;64;"49";2012;44823;21580;23243
60;64;"2B";2012;11079;5396;5683
60;64;"15";2012;10509;5265;5244
60;64;"37";2012;35973;17240;18733
60;64;"60";2012;46231;23312;22919
60;64;"23";2012;9786;4966;4820
60;64;"48";2012;5508;2827;2681
60;64;"50";2012;33527;16359;17168
60;64;"24";2012;32369;15781;16588
60;64;"44";2012;74585;35508;39077
60;64;"30";2012;47417;22787;24630
60;64;"53";2012;18111;8902;9209
60;64;"61";2012;20057;9883;10174
60;64;"26";2012;31248;15161;16087
60;64;"54";2012;43125;21112;22013
60;64;"25";2012;31687;15583;16104
60;64;"56";2012;50530;24463;26067
60;64;"31";2012;66855;31760;35095
60;64;"38";2012;67798;33174;34624
60;64;"55";2012;12432;6350;6082
60;64;"62";2012;86159;41223;44936
60;64;"32";2012;13568;6645;6923
65;69;"75";2012;85591;38167;47424
65;69;"76";2012;47666;22165;25501
65;69;"78";2012;51077;24900;26177
65;69;"79";2012;15925;7764;8161
65;69;"73";2012;17821;8500;9321
65;69;"77";2012;40866;19715;21151
65;69;"74";2012;29412;14149;15263
65;69;"92";2012;51499;23938;27561
65;69;"81";2012;17629;8341;9288
65;69;"91";2012;41963;19912;22051
65;69;"85";2012;29189;13989;15200
65;69;"87";2012;17282;8318;8964
65;69;"63";2012;27542;13157;14385
65;69;"86";2012;17433;8356;9077
65;69;"80";2012;21622;10368;11254
65;69;"02";2012;20140;9499;10641
65;69;"45";2012;26166;12652;13514
65;69;"01";2012;23499;11493;12006
65;69;"03";2012;17323;8211;9112
65;69;"93";2012;43810;22054;21756
65;69;"27";2012;22582;10777;11805
65;69;"89";2012;15288;7446;7842
65;69;"83";2012;59379;28243;31136
65;69;"67";2012;43649;21197;22452
65;69;"69";2012;66024;31446;34578
65;69;"04";2012;8782;4166;4616
65;69;"94";2012;44596;21159;23437
65;69;"88";2012;15481;7453;8028
65;69;"82";2012;11057;5303;5754
65;69;"84";2012;26376;12559;13817
65;69;"68";2012;30612;15129;15483
65;69;"70";2012;10518;5197;5321
65;69;"64";2012;31133;14376;16757
65;69;"95";2012;35344;17346;17998
65;69;"29";2012;37729;17478;20251
65;69;"31";2012;45251;21475;23776
65;69;"46";2012;9795;4783;5012
65;69;"10";2012;12695;6112;6583
65;69;"71";2012;27125;13059;14066
65;69;"65";2012;11910;5603;6307
65;69;"28";2012;16336;7897;8439
65;69;"90";2012;5339;2606;2733
65;69;"32";2012;10011;4897;5114
65;69;"47";2012;17424;8350;9074
65;69;"11";2012;18493;8982;9511
65;69;"05";2012;6943;3390;3553
65;69;"66";2012;23792;11340;12452
65;69;"972";2012;16961;7816;9145
65;69;"974";2012;24247;11380;12867
65;69;"33";2012;57577;27075;30502
65;69;"48";2012;3776;1950;1826
65;69;"12";2012;14062;6751;7311
65;69;"06";2012;56888;26362;30526
65;69;"971";2012;16370;7342;9028
65;69;"30";2012;33883;16138;17745
65;69;"40";2012;19128;9280;9848
65;69;"34";2012;49131;23396;25735
65;69;"49";2012;29318;13650;15668
65;69;"72";2012;22922;10916;12006
65;69;"07";2012;15694;7592;8102
65;69;"09";2012;7605;3677;3928
65;69;"39";2012;12025;5902;6123
65;69;"41";2012;14795;6998;7797
65;69;"35";2012;34278;16107;18171
65;69;"50";2012;21461;10195;11266
65;69;"14";2012;26642;12335;14307
65;69;"08";2012;10657;5053;5604
65;69;"973";2012;3433;1740;1693
65;69;"2A";2012;8080;3908;4172
65;69;"42";2012;32432;15343;17089
65;69;"57";2012;41760;19789;21971
65;69;"13";2012;89336;42362;46974
65;69;"15";2012;7151;3417;3734
65;69;"17";2012;32956;15847;17109
65;69;"19";2012;12171;5760;6411
65;69;"2B";2012;8867;4399;4468
65;69;"43";2012;10077;4860;5217
65;69;"58";2012;11616;5496;6120
65;69;"21";2012;21057;10030;11027
65;69;"16";2012;16765;7973;8792
65;69;"18";2012;15238;7541;7697
65;69;"22";2012;28374;13483;14891
65;69;"24";2012;22399;10840;11559
65;69;"36";2012;11779;5560;6219
65;69;"51";2012;20665;9867;10798
65;69;"25";2012;21096;10141;10955
65;69;"37";2012;24845;11894;12951
65;69;"26";2012;22697;10752;11945
65;69;"23";2012;6361;3175;3186
65;69;"59";2012;80411;36618;43793
65;69;"53";2012;11755;5612;6143
65;69;"52";2012;8370;4006;4364
65;69;"44";2012;46665;21665;25000
65;69;"54";2012;26671;12480;14191
65;69;"56";2012;32527;15213;17314
65;69;"55";2012;7316;3510;3806
65;69;"60";2012;27392;13524;13868
65;69;"38";2012;48710;23749;24961
65;69;"61";2012;12768;6084;6684
65;69;"62";2012;48713;22267;26446
70;74;"74";2012;23728;10979;12749
70;74;"75";2012;68167;29155;39012
70;74;"77";2012;35840;16431;19409
70;74;"84";2012;22461;10188;12273
70;74;"73";2012;15736;7033;8703
70;74;"83";2012;50004;23171;26833
70;74;"76";2012;46942;19905;27037
70;74;"87";2012;17074;7681;9393
70;74;"92";2012;44266;19369;24897
70;74;"78";2012;44288;20465;23823
70;74;"82";2012;10174;4675;5499
70;74;"02";2012;20351;8848;11503
70;74;"79";2012;16585;7722;8863
70;74;"81";2012;18005;8267;9738
70;74;"85";2012;29883;13901;15982
70;74;"93";2012;38029;17317;20712
70;74;"27";2012;20519;9299;11220
70;74;"89";2012;15507;7228;8279
70;74;"91";2012;38013;17508;20505
70;74;"80";2012;21407;9330;12077
70;74;"69";2012;57255;25610;31645
70;74;"63";2012;26051;11886;14165
70;74;"86";2012;17740;8135;9605
70;74;"88";2012;17133;7683;9450
70;74;"51";2012;20436;8934;11502
70;74;"45";2012;24889;11497;13392
70;74;"01";2012;19813;9320;10493
70;74;"03";2012;17502;7702;9800
70;74;"33";2012;52073;23697;28376
70;74;"95";2012;31050;14323;16727
70;74;"29";2012;40761;17611;23150
70;74;"52";2012;8730;3987;4743
70;74;"16";2012;16465;7677;8788
70;74;"10";2012;12490;5550;6940
70;74;"04";2012;7968;3824;4144
70;74;"94";2012;38140;16461;21679
70;74;"28";2012;15732;7203;8529
70;74;"90";2012;5188;2320;2868
70;74;"53";2012;12926;5807;7119
70;74;"17";2012;31183;14341;16842
70;74;"70";2012;10289;4806;5483
70;74;"64";2012;30366;13766;16600
70;74;"35";2012;35888;16088;19800
70;74;"972";2012;15415;7038;8377
70;74;"31";2012;39909;17993;21916
70;74;"46";2012;9550;4596;4954
70;74;"18";2012;15131;6824;8307
70;74;"71";2012;26639;12086;14553
70;74;"34";2012;42028;19291;22737
70;74;"971";2012;13298;5914;7384
70;74;"30";2012;29266;13637;15629
70;74;"32";2012;9843;4719;5124
70;74;"47";2012;16633;7802;8831
70;74;"11";2012;16892;7655;9237
70;74;"05";2012;6282;2976;3306
70;74;"66";2012;22034;9972;12062
70;74;"37";2012;24261;10948;13313
70;74;"974";2012;18441;7912;10529
70;74;"54";2012;27820;12252;15568
70;74;"48";2012;3735;1765;1970
70;74;"12";2012;14794;6930;7864
70;74;"65";2012;11509;5145;6364
70;74;"36";2012;12102;5544;6558
70;74;"973";2012;2343;1083;1260
70;74;"40";2012;18525;8514;10011
70;74;"55";2012;7971;3626;4345
70;74;"19";2012;12784;5809;6975
70;74;"72";2012;23700;10602;13098
70;74;"07";2012;14454;6825;7629
70;74;"68";2012;28562;12955;15607
70;74;"39";2012;11047;5058;5989
70;74;"41";2012;15616;7197;8419
70;74;"56";2012;34138;15133;19005
70;74;"2A";2012;6820;3213;3607
70;74;"06";2012;50426;22391;28035
70;74;"67";2012;40043;18331;21712
70;74;"38";2012;41527;19239;22288
70;74;"15";2012;7963;3630;4333
70;74;"42";2012;32531;14579;17952
70;74;"49";2012;29418;13247;16171
70;74;"13";2012;76072;34309;41763
70;74;"43";2012;10529;4818;5711
70;74;"09";2012;7266;3331;3935
70;74;"26";2012;20223;9461;10762
70;74;"08";2012;11385;5059;6326
70;74;"25";2012;20358;9266;11092
70;74;"50";2012;24205;10886;13319
70;74;"14";2012;26764;11747;15017
70;74;"57";2012;42576;19040;23536
70;74;"2B";2012;7781;3753;4028
70;74;"22";2012;29803;13146;16657
70;74;"24";2012;22212;10392;11820
70;74;"21";2012;19841;8851;10990
70;74;"23";2012;6850;3109;3741
70;74;"59";2012;85670;36087;49583
70;74;"58";2012;12125;5556;6569
70;74;"44";2012;46190;20330;25860
70;74;"62";2012;53168;22032;31136
70;74;"61";2012;13832;6295;7537
70;74;"60";2012;25660;11698;13962
75;79;"75";2012;62127;24649;37478
75;79;"73";2012;14366;6251;8115
75;79;"82";2012;10046;4457;5589
75;79;"76";2012;44162;17270;26892
75;79;"84";2012;20786;8901;11885
75;79;"74";2012;20794;8703;12091
75;79;"77";2012;30571;12706;17865
75;79;"90";2012;5038;2120;2918
75;79;"79";2012;15949;6926;9023
75;79;"83";2012;46780;20543;26237
75;79;"80";2012;20036;8177;11859
75;79;"93";2012;35131;14627;20504
75;79;"27";2012;18802;7687;11115
75;79;"81";2012;17527;7692;9835
75;79;"91";2012;32823;14092;18731
75;79;"88";2012;15731;6291;9440
75;79;"02";2012;19829;7995;11834
75;79;"92";2012;43380;17165;26215
75;79;"78";2012;39176;16626;22550
75;79;"57";2012;37428;15417;22011
75;79;"85";2012;26790;11841;14949
75;79;"87";2012;17214;7392;9822
75;79;"89";2012;14262;5937;8325
75;79;"03";2012;17422;7181;10241
75;79;"33";2012;49401;20609;28792
75;79;"95";2012;27428;11208;16220
75;79;"58";2012;11391;4575;6816
75;79;"86";2012;16905;7370;9535
75;79;"16";2012;16194;6980;9214
75;79;"69";2012;55604;23130;32474
75;79;"63";2012;24198;9724;14474
75;79;"94";2012;36656;14424;22232
75;79;"28";2012;14762;6211;8551
75;79;"51";2012;19005;7700;11305
75;79;"45";2012;23414;9966;13448
75;79;"01";2012;18010;7878;10132
75;79;"39";2012;10724;4504;6220
75;79;"64";2012;29309;12452;16857
75;79;"35";2012;32874;13788;19086
75;79;"29";2012;37693;14623;23070
75;79;"21";2012;18586;7846;10740
75;79;"46";2012;9164;4051;5113
75;79;"10";2012;11650;4725;6925
75;79;"04";2012;6991;3151;3840
75;79;"34";2012;40178;17356;22822
75;79;"971";2012;10578;4505;6073
75;79;"59";2012;80384;30254;50130
75;79;"22";2012;27611;11277;16334
75;79;"17";2012;29082;12648;16434
75;79;"70";2012;9230;3866;5364
75;79;"05";2012;5393;2381;3012
75;79;"66";2012;21398;9336;12062
75;79;"972";2012;11423;4898;6525
75;79;"52";2012;7964;3317;4647
75;79;"23";2012;7111;3060;4051
75;79;"18";2012;14203;5987;8216
75;79;"40";2012;16894;7441;9453
75;79;"65";2012;11571;4913;6658
75;79;"36";2012;11908;5035;6873
75;79;"30";2012;27978;12307;15671
75;79;"53";2012;12702;5568;7134
75;79;"47";2012;15894;7031;8863
75;79;"11";2012;16553;7341;9212
75;79;"41";2012;14993;6503;8490
75;79;"07";2012;13391;5873;7518
75;79;"37";2012;22591;9708;12883
75;79;"60";2012;22483;9401;13082
75;79;"54";2012;26494;10769;15725
75;79;"48";2012;3406;1493;1913
75;79;"71";2012;25735;10817;14918
75;79;"06";2012;48708;20786;27922
75;79;"67";2012;35711;14690;21021
75;79;"973";2012;1726;752;974
75;79;"61";2012;13385;5756;7629
75;79;"24";2012;21712;9480;12232
75;79;"19";2012;12583;5310;7273
75;79;"72";2012;22238;9489;12749
75;79;"43";2012;9811;4012;5799
75;79;"68";2012;26403;10871;15532
75;79;"31";2012;37800;16087;21713
75;79;"62";2012;50033;18617;31416
75;79;"25";2012;18158;7693;10465
75;79;"12";2012;14612;6350;8262
75;79;"42";2012;30788;12559;18229
75;79;"08";2012;10741;4358;6383
75;79;"38";2012;38344;16314;22030
75;79;"32";2012;9737;4455;5282
75;79;"55";2012;7839;3203;4636
75;79;"49";2012;27369;11428;15941
75;79;"13";2012;71807;30114;41693
75;79;"15";2012;7807;3255;4552
75;79;"09";2012;7520;3330;4190
75;79;"974";2012;12549;5036;7513
75;79;"44";2012;41672;17027;24645
75;79;"56";2012;31111;12851;18260
75;79;"2A";2012;6324;2809;3515
75;79;"14";2012;25094;10065;15029
75;79;"26";2012;18272;7855;10417
75;79;"2B";2012;6661;2908;3753
75;79;"50";2012;23235;9673;13562
80;84;"88";2012;11950;4169;7781
80;84;"81";2012;15132;6033;9099
80;84;"86";2012;13500;5306;8194
80;84;"91";2012;22806;8596;14210
80;84;"82";2012;8158;3344;4814
80;84;"87";2012;14082;5334;8748
80;84;"89";2012;12019;4521;7498
80;84;"83";2012;35829;14067;21762
80;84;"85";2012;20616;7906;12710
80;84;"02";2012;15136;5516;9620
80;84;"92";2012;36440;12975;23465
80;84;"94";2012;28038;9785;18253
80;84;"971";2012;7355;2931;4424
80;84;"90";2012;3797;1347;2450
80;84;"84";2012;15636;6005;9631
80;84;"01";2012;13925;5408;8517
80;84;"03";2012;13915;5141;8774
80;84;"93";2012;24914;8987;15927
80;84;"95";2012;20304;7290;13014
80;84;"972";2012;8464;3461;5003
80;84;"974";2012;8243;2948;5295
80;84;"33";2012;40436;14689;25747
80;84;"27";2012;14099;5316;8783
80;84;"04";2012;5484;2146;3338
80;84;"06";2012;40008;15324;24684
80;84;"08";2012;7859;2827;5032
80;84;"973";2012;1052;433;619
80;84;"63";2012;19103;6673;12430
80;84;"34";2012;30709;12294;18415
80;84;"57";2012;26633;9618;17015
80;84;"05";2012;4371;1790;2581
80;84;"07";2012;11129;4295;6834
80;84;"09";2012;5900;2386;3514
80;84;"39";2012;8777;3422;5355
80;84;"64";2012;22546;8384;14162
80;84;"35";2012;25058;9464;15594
80;84;"58";2012;9129;3328;5801
80;84;"21";2012;15117;5628;9489
80;84;"75";2012;51887;18198;33689
80;84;"69";2012;42588;15781;26807
80;84;"40";2012;13065;5228;7837
80;84;"65";2012;9030;3342;5688
80;84;"28";2012;12136;4824;7312
80;84;"51";2012;14549;5208;9341
80;84;"45";2012;18342;7107;11235
80;84;"76";2012;34294;12318;21976
80;84;"70";2012;7321;2737;4584
80;84;"41";2012;11969;4723;7246
80;84;"66";2012;16600;6270;10330
80;84;"29";2012;29697;10258;19439
80;84;"52";2012;6207;2292;3915
80;84;"16";2012;12953;4996;7957
80;84;"10";2012;8627;3221;5406
80;84;"71";2012;20918;7857;13061
80;84;"42";2012;24620;8785;15835
80;84;"36";2012;9462;3714;5748
80;84;"59";2012;60107;19927;40180
80;84;"22";2012;22146;8093;14053
80;84;"17";2012;23297;9093;14204
80;84;"11";2012;13457;5408;8049
80;84;"72";2012;17518;6808;10710
80;84;"43";2012;7677;2793;4884
80;84;"37";2012;17778;6917;10861
80;84;"60";2012;16811;6111;10700
80;84;"46";2012;7406;2981;4425
80;84;"77";2012;22983;8541;14442
80;84;"12";2012;11861;4823;7038
80;84;"73";2012;11183;4354;6829
80;84;"67";2012;26505;9440;17065
80;84;"30";2012;21091;8271;12820
80;84;"53";2012;10215;4094;6121
80;84;"47";2012;12964;5207;7757
80;84;"78";2012;28258;11041;17217
80;84;"13";2012;55834;21276;34558
80;84;"74";2012;16186;6099;10087
80;84;"68";2012;19933;7111;12822
80;84;"31";2012;29642;11233;18409
80;84;"23";2012;6121;2331;3790
80;84;"18";2012;11068;4082;6986
80;84;"79";2012;12836;5333;7503
80;84;"14";2012;19288;6902;12386
80;84;"44";2012;32843;11598;21245
80;84;"38";2012;29361;11224;18137
80;84;"61";2012;10605;4118;6487
80;84;"24";2012;17342;6868;10474
80;84;"19";2012;10120;3870;6250
80;84;"80";2012;15499;5729;9770
80;84;"15";2012;6301;2448;3853
80;84;"2A";2012;4564;1854;2710
80;84;"55";2012;6109;2170;3939
80;84;"54";2012;20182;7276;12906
80;84;"48";2012;2824;1137;1687
80;84;"32";2012;7971;3374;4597
80;84;"50";2012;17823;6766;11057
80;84;"49";2012;22576;8705;13871
80;84;"2B";2012;4984;2025;2959
80;84;"25";2012;13684;5155;8529
80;84;"56";2012;23031;8058;14973
80;84;"62";2012;37565;12608;24957
80;84;"26";2012;14157;5498;8659
85;89;"86";2012;9348;3133;6215
85;89;"87";2012;9542;3160;6382
85;89;"81";2012;10357;3584;6773
85;89;"89";2012;8191;2726;5465
85;89;"85";2012;13232;4394;8838
85;89;"92";2012;24739;7520;17219
85;89;"63";2012;12460;3774;8686
85;89;"88";2012;7472;2154;5318
85;89;"28";2012;7934;2781;5153
85;89;"27";2012;8757;2728;6029
85;89;"45";2012;12277;4223;8054
85;89;"94";2012;18611;5811;12800
85;89;"91";2012;14228;4374;9854
85;89;"82";2012;5607;1924;3683
85;89;"95";2012;12539;3839;8700
85;89;"29";2012;18966;5384;13582
85;89;"83";2012;23817;7973;15844
85;89;"93";2012;14981;4462;10519
85;89;"02";2012;9328;2826;6502
85;89;"04";2012;3584;1166;2418
85;89;"65";2012;6020;1946;4074
85;89;"971";2012;4757;1844;2913
85;89;"90";2012;2385;672;1713
85;89;"84";2012;10506;3336;7170
85;89;"01";2012;9195;2952;6243
85;89;"03";2012;9515;3115;6400
85;89;"64";2012;15106;4772;10334
85;89;"66";2012;10731;3617;7114
85;89;"972";2012;5093;1785;3308
85;89;"31";2012;19771;6225;13546
85;89;"46";2012;5005;1689;3316
85;89;"10";2012;6172;1907;4265
85;89;"12";2012;8186;2929;5257
85;89;"06";2012;27455;9242;18213
85;89;"67";2012;16100;4661;11439
85;89;"30";2012;13903;4590;9313
85;89;"32";2012;5365;1979;3386
85;89;"47";2012;8835;3024;5811
85;89;"11";2012;9089;3062;6027
85;89;"05";2012;3247;1029;2218
85;89;"07";2012;7543;2462;5081
85;89;"68";2012;11551;3298;8253
85;89;"974";2012;4641;1438;3203
85;89;"33";2012;28527;9228;19299
85;89;"48";2012;1895;642;1253
85;89;"50";2012;11150;3538;7612
85;89;"14";2012;12879;3869;9010
85;89;"08";2012;4758;1446;3312
85;89;"973";2012;627;225;402
85;89;"40";2012;8559;2844;5715
85;89;"34";2012;20905;6999;13906
85;89;"49";2012;15074;5095;9979
85;89;"13";2012;36709;11745;24964
85;89;"15";2012;4192;1385;2807
85;89;"09";2012;4213;1508;2705
85;89;"39";2012;5833;2001;3832
85;89;"41";2012;8245;2863;5382
85;89;"35";2012;16754;5268;11486
85;89;"58";2012;6099;1993;4106
85;89;"21";2012;10186;3304;6882
85;89;"75";2012;36791;11314;25477
85;89;"69";2012;27275;8554;18721
85;89;"71";2012;13587;4570;9017
85;89;"42";2012;15801;4969;10832
85;89;"57";2012;14951;4612;10339
85;89;"51";2012;9611;2867;6744
85;89;"22";2012;13510;4044;9466
85;89;"76";2012;21465;6837;14628
85;89;"70";2012;4320;1353;2967
85;89;"72";2012;11663;4018;7645
85;89;"43";2012;5138;1648;3490
85;89;"37";2012;12164;4131;8033
85;89;"52";2012;3984;1192;2792
85;89;"16";2012;8818;2926;5892
85;89;"77";2012;14598;4472;10126
85;89;"79";2012;8713;3100;5613
85;89;"73";2012;7383;2247;5136
85;89;"36";2012;6356;2170;4186
85;89;"59";2012;36210;10032;26178
85;89;"53";2012;6832;2357;4475
85;89;"17";2012;15687;5348;10339
85;89;"78";2012;17919;5734;12185
85;89;"80";2012;9740;3170;6570
85;89;"74";2012;10059;3244;6815
85;89;"2A";2012;2503;876;1627
85;89;"60";2012;10264;3250;7014
85;89;"23";2012;4066;1405;2661
85;89;"18";2012;7311;2405;4906
85;89;"61";2012;6977;2237;4740
85;89;"24";2012;11631;3813;7818
85;89;"44";2012;21455;6476;14979
85;89;"38";2012;18276;5995;12281
85;89;"25";2012;8193;2711;5482
85;89;"56";2012;14466;4322;10144
85;89;"19";2012;7508;2467;5041
85;89;"2B";2012;3235;957;2278
85;89;"62";2012;22539;6613;15926
85;89;"55";2012;3787;1212;2575
85;89;"54";2012;12595;3793;8802
85;89;"26";2012;9440;3292;6148
90;94;"92";2012;6826;1745;5081
90;94;"87";2012;2390;680;1710
90;94;"27";2012;2109;491;1618
90;94;"81";2012;2279;672;1607
90;94;"93";2012;3943;1007;2936
90;94;"02";2012;1894;456;1438
90;94;"63";2012;2780;694;2086
90;94;"94";2012;4975;1451;3524
90;94;"88";2012;1795;436;1359
90;94;"51";2012;2180;402;1778
90;94;"95";2012;3354;842;2512
90;94;"89";2012;1909;472;1437
90;94;"91";2012;4111;1126;2985
90;94;"33";2012;7063;1783;5280
90;94;"69";2012;7273;1954;5319
90;94;"04";2012;1026;261;765
90;94;"34";2012;5460;1473;3987
90;94;"28";2012;2087;600;1487
90;94;"82";2012;1302;357;945
90;94;"45";2012;3164;834;2330
90;94;"01";2012;2226;568;1658
90;94;"03";2012;2310;588;1722
90;94;"64";2012;4394;1087;3307
90;94;"35";2012;3957;1029;2928
90;94;"29";2012;4374;915;3459
90;94;"52";2012;850;183;667
90;94;"16";2012;2156;550;1606
90;94;"10";2012;1632;457;1175
90;94;"71";2012;3317;895;2422
90;94;"65";2012;1771;455;1316
90;94;"971";2012;1940;605;1335
90;94;"90";2012;587;140;447
90;94;"53";2012;1573;387;1186
90;94;"17";2012;3914;1076;2838
90;94;"70";2012;972;234;738
90;94;"05";2012;858;227;631
90;94;"66";2012;2853;776;2077
90;94;"972";2012;2125;593;1532
90;94;"83";2012;6498;1795;4703
90;94;"46";2012;1057;294;763
90;94;"18";2012;1657;527;1130
90;94;"12";2012;1875;472;1403
90;94;"06";2012;8276;2059;6217
90;94;"36";2012;1563;446;1117
90;94;"30";2012;3484;963;2521
90;94;"84";2012;2734;728;2006
90;94;"47";2012;2132;527;1605
90;94;"11";2012;2202;625;1577
90;94;"72";2012;3194;895;2299
90;94;"07";2012;1808;425;1383
90;94;"37";2012;3297;958;2339
90;94;"31";2012;5332;1385;3947
90;94;"54";2012;2753;631;2122
90;94;"48";2012;513;188;325
90;94;"2A";2012;921;261;660
90;94;"73";2012;1868;490;1378
90;94;"67";2012;3833;905;2928
90;94;"973";2012;221;77;144
90;94;"32";2012;1280;405;875
90;94;"55";2012;815;194;621
90;94;"19";2012;1716;487;1229
90;94;"13";2012;9628;2365;7263
90;94;"74";2012;2659;707;1952
90;94;"68";2012;2347;558;1789
90;94;"974";2012;1523;350;1173
90;94;"85";2012;2989;803;2186
90;94;"56";2012;3384;787;2597
90;94;"50";2012;2629;653;1976
90;94;"14";2012;3252;738;2514
90;94;"08";2012;879;190;689
90;94;"38";2012;4477;1180;3297
90;94;"40";2012;2194;586;1608
90;94;"86";2012;2379;620;1759
90;94;"49";2012;3676;1033;2643
90;94;"2B";2012;1045;263;782
90;94;"15";2012;1071;276;795
90;94;"09";2012;937;241;696
90;94;"39";2012;1511;318;1193
90;94;"41";2012;1925;555;1370
90;94;"43";2012;1087;276;811
90;94;"58";2012;1617;399;1218
90;94;"21";2012;2804;684;2120
90;94;"75";2012;11295;2913;8382
90;94;"77";2012;3876;896;2980
90;94;"79";2012;2063;585;1478
90;94;"42";2012;3992;968;3024
90;94;"57";2012;3202;700;2502
90;94;"59";2012;6689;1431;5258
90;94;"22";2012;3327;765;2562
90;94;"76";2012;5561;1214;4347
90;94;"78";2012;5167;1141;4026
90;94;"80";2012;2162;539;1623
90;94;"25";2012;2151;623;1528
90;94;"61";2012;1617;445;1172
90;94;"60";2012;2435;651;1784
90;94;"23";2012;898;247;651
90;94;"62";2012;5006;1064;3942
90;94;"24";2012;2832;829;2003
90;94;"44";2012;5072;1094;3978
90;94;"26";2012;2298;671;1627
95;NA;"87";2012;1171;231;940
95;NA;"93";2012;2028;422;1606
95;NA;"02";2012;865;123;742
95;NA;"63";2012;1233;214;1019
95;NA;"57";2012;1173;209;964
95;NA;"33";2012;3560;616;2944
95;NA;"27";2012;1072;183;889
95;NA;"81";2012;1092;227;865
95;NA;"03";2012;1335;263;1072
95;NA;"75";2012;5800;1090;4710
95;NA;"69";2012;3831;664;3167
95;NA;"04";2012;453;126;327
95;NA;"94";2012;2685;602;2083
95;NA;"88";2012;840;149;691
95;NA;"51";2012;1141;173;968
95;NA;"45";2012;1650;332;1318
95;NA;"01";2012;1267;230;1037
95;NA;"39";2012;696;155;541
95;NA;"64";2012;2152;391;1761
95;NA;"95";2012;1504;288;1216
95;NA;"58";2012;740;120;620
95;NA;"21";2012;1585;255;1330
95;NA;"16";2012;1086;181;905
95;NA;"10";2012;845;137;708
95;NA;"40";2012;1166;130;1036
95;NA;"34";2012;2649;437;2212
95;NA;"28";2012;1022;231;791
95;NA;"82";2012;621;113;508
95;NA;"22";2012;1415;239;1176
95;NA;"76";2012;2330;410;1920
95;NA;"70";2012;521;69;452
95;NA;"05";2012;356;61;295
95;NA;"35";2012;1782;292;1490
95;NA;"89";2012;913;172;741
95;NA;"52";2012;392;74;318
95;NA;"46";2012;490;92;398
95;NA;"77";2012;1820;274;1546
95;NA;"71";2012;1685;309;1376
95;NA;"65";2012;916;164;752
95;NA;"971";2012;867;255;612
95;NA;"59";2012;3355;538;2817
95;NA;"53";2012;1034;146;888
95;NA;"17";2012;2012;402;1610
95;NA;"11";2012;1154;256;898
95;NA;"41";2012;956;187;769
95;NA;"66";2012;1135;175;960
95;NA;"29";2012;1848;306;1542
95;NA;"83";2012;3038;530;2508
95;NA;"23";2012;571;98;473
95;NA;"18";2012;833;241;592
95;NA;"12";2012;1056;278;778
95;NA;"06";2012;4055;752;3303
95;NA;"36";2012;634;75;559
95;NA;"90";2012;341;40;301
95;NA;"84";2012;1228;184;1044
95;NA;"47";2012;1085;182;903
95;NA;"78";2012;2988;527;2461
95;NA;"72";2012;1686;265;1421
95;NA;"07";2012;955;158;797
95;NA;"972";2012;925;231;694
95;NA;"60";2012;1072;210;862
95;NA;"54";2012;1321;196;1125
95;NA;"48";2012;231;36;195
95;NA;"79";2012;1184;202;982
95;NA;"42";2012;2007;296;1711
95;NA;"67";2012;1462;256;1206
95;NA;"30";2012;1593;325;1268
95;NA;"61";2012;916;160;756
95;NA;"24";2012;1323;241;1082
95;NA;"19";2012;966;191;775
95;NA;"13";2012;4403;712;3691
95;NA;"43";2012;569;90;479
95;NA;"37";2012;1810;232;1578
95;NA;"91";2012;1965;312;1653
95;NA;"85";2012;1343;232;1111
95;NA;"25";2012;888;174;714
95;NA;"2A";2012;391;65;326
95;NA;"73";2012;906;154;752
95;NA;"08";2012;509;76;433
95;NA;"973";2012;98;35;63
95;NA;"92";2012;3603;823;2780
95;NA;"55";2012;417;62;355
95;NA;"49";2012;1931;390;1541
95;NA;"80";2012;1029;162;867
95;NA;"74";2012;1214;199;1015
95;NA;"68";2012;969;176;793
95;NA;"31";2012;2510;467;2043
95;NA;"62";2012;1669;288;1381
95;NA;"56";2012;1410;236;1174
95;NA;"50";2012;1286;237;1049
95;NA;"14";2012;1479;260;1219
95;NA;"44";2012;2365;464;1901
95;NA;"38";2012;2035;352;1683
95;NA;"32";2012;675;170;505
95;NA;"86";2012;1383;242;1141
95;NA;"26";2012;1008;224;784
95;NA;"2B";2012;451;86;365
95;NA;"15";2012;568;114;454
95;NA;"09";2012;492;97;395
95;NA;"974";2012;529;106;423
